111111111111111111111111111
111111111111111111111111111
111111111111111111111111111
111111111111111111111111111
111111111111111111111111111
111112222222222222222211111
111112222222222222222211111
111112222222222222222211111
111112222222222222222211111
111112222222222222222211111
111112222222222222222211111
111112222222222222222211111
111112222222222222222211111
111112222222222222222211111
111112222222222222222211111
111112222222222222222211111
111112222222222222222211111
111112222222222222222211111
111112222222222222222211111
111112222222222222222211111
111112222222222222222211111
111112222222222222222211111
111112222222222222222211111
111112222222211112112211111
111112222222212222212211111
111112222222212222212211111
111112222222212222212211111
111111111111111111111111111
111111111111111111111111111
111111111111111111111111111
111111111111111111111111111
111111111111111111111111111